# Sea surface height for the Netherlands based on the 6 main tide gauges. 
# Cite https://doi.org/10.2112/JCOASTRES-D-11-00169.1 (method) https://doi.org/10.5281/zenodo.1065964 (data)
# Lineage: https://doi.org/10.5281/zenodo.1065964 (notebooks/dutch-sea-level-monitor.ipynb)
# year -> year over which sea-level is averaged
# date -> first day of the year over which the sea level is averaged
# height -> mean sea surface height over main tide gauges, based on PSMSL RLR [mm relative to NAP(2005)]
# u2/v2 -> signed squared mean wind velocity offshore [m2/s2]
# predicted_linear_with_wind -> fitted sea surface height based on linear model with wind and tide [mm relative to NAP(2005)]
# predicted_linear -> fitted sea surface height based on linear model with tide [mm relative to NAP(2005)]
# predicted_linear_mean_wind_last_tide  -> fitted sea surface height based on linear model with wind and nodal tide at epoch   [mm relative to NAP(2005)]
year,height,u2,v2,predicted_linear_with_wind,predicted_linear,predicted_linear_mean_wind_last_tide,date
1890,-194.66666666666666,3.3482018,0.66977715,-164.41781114744438,-167.77670849255094,-123.20420635900763,1890-01-01
1891,-179.0,3.3482018,0.66977715,-160.93826103671708,-163.58042886789707,-121.3476734571642,1891-01-01
1892,-166.5,3.3482018,0.66977715,-158.65745734495735,-160.79567439869783,-119.49114055532075,1892-01-01
1893,-142.16666666666666,3.3482018,0.66977715,-157.62328976848286,-159.51947186408606,-117.63460765347733,1893-01-01
1894,-141.83333333333334,3.3482018,0.66977715,-157.74293356745736,-159.67856977812457,-115.77807475163391,1894-01-01
1895,-173.0,3.3482018,0.66977715,-158.79332718704012,-161.03770667388255,-113.92154184979046,1895-01-01
1896,-185.0,3.3482018,0.66977715,-160.4463503992127,-163.22616631410375,-112.06500894794704,1896-01-01
1897,-179.33333333333334,3.3482018,0.66977715,-162.3058609747558,-165.77962240086867,-110.20847604610358,1897-01-01
1898,-138.33333333333334,3.3482018,0.66977715,-163.95240935959944,-168.19254954973704,-108.35194314426016,1898-01-01
1899,-141.0,3.3482018,0.66977715,-164.99058417265684,-169.97528462349288,-106.49541024241671,1899-01-01
1900,-176.5,3.3482018,0.66977715,-165.09364438746613,-170.70929760984018,-104.63887734057329,1900-01-01
1901,-196.83333333333334,3.3482018,0.66977715,-164.04040032636598,-170.09443332567503,-102.78234443872987,1901-01-01
1902,-225.16666666666666,3.3482018,0.66977715,-161.74018051360818,-167.98279152598968,-100.92581153688641,1902-01-01
1903,-113.83333333333333,3.3482018,0.66977715,-158.24306624615878,-164.39542118966125,-99.06927863504299,1903-01-01
1904,-151.83333333333334,3.3482018,0.66977715,-153.73423865185077,-159.51994460946642,-97.21274573319954,1904-01-01
1905,-176.66666666666666,3.3482018,0.66977715,-148.51307631244367,-153.68937946789487,-95.35621283135612,1905-01-01
1906,-139.83333333333334,3.3482018,0.66977715,-142.95936281383604,-147.3445493634876,-93.49967992951267,1906-01-01
1907,-162.66666666666666,3.3482018,0.66977715,-137.49041855662762,-140.98432571113872,-91.64314702766924,1907-01-01
1908,-169.83333333333334,3.3482018,0.66977715,-132.5139955871402,-135.10931747721585,-89.78661412582579,1908-01-01
1909,-119.5,3.3482018,0.66977715,-128.38225245938008,-130.1653647880219,-87.93008122398237,1909-01-01
1910,-110.33333333333333,3.3482018,0.66977715,-125.3520042295983,-126.49321458797748,-86.07354832213895,1910-01-01
1911,-132.33333333333334,3.3482018,0.66977715,-123.55573437757772,-124.29005872313456,-84.21701542029551,1911-01-01
1912,-70.16666666666667,3.3482018,0.66977715,-122.98664069297588,-123.58727585071095,-82.36048251845207,1912-01-01
1913,-98.83333333333333,3.3482018,0.66977715,-123.49940307691601,-124.24688956347522,-80.50394961660864,1913-01-01
1914,-86.5,3.3482018,0.66977715,-124.82658659298525,-125.97714251928461,-78.6474167147652,1914-01-01
1915,-124.33333333333333,3.3482018,0.66977715,-126.60882826819763,-128.36542864109921,-76.79088381292176,1915-01-01
1916,-73.33333333333333,3.3482018,0.66977715,-128.43540029944884,-130.92486615523467,-74.93435091107833,1916-01-01
1917,-127.83333333333333,3.3482018,0.66977715,-129.8905710810187,-133.14925452179062,-73.07781800923489,1917-01-01
1918,-131.5,3.3482018,0.66977715,-130.60053103783827,-134.57021197677707,-71.22128510739147,1918-01-01
1919,-153.66666666666666,3.3482018,0.66977715,-130.27558649661196,-134.81004426824055,-69.36475220554803,1919-01-01
1920,-149.16666666666666,3.3482018,0.66977715,-128.74285894857397,-133.62437701148826,-67.50821930370459,1920-01-01
1921,-119.33333333333333,3.3482018,0.66977715,-125.96579876450554,-130.92973952316066,-65.65168640186116,1921-01-01
1922,-126.33333333333333,3.3482018,0.66977715,-122.04831074541028,-126.81298660036968,-63.79515350001772,1922-01-01
1923,-104.0,3.3482018,0.66977715,-117.2230258360417,-121.52149475867644,-61.938620598174275,1923-01-01
1924,-130.0,3.3482018,0.66977715,-111.82504283523747,-115.43523953157079,-60.08208769633084,1924-01-01
1925,-75.16666666666667,3.3482018,0.66977715,-106.25410401560822,-109.02390561488997,-58.225554794487415,1925-01-01
1926,-93.0,3.3482018,0.66977715,-100.92947409117872,-102.79387106185771,-56.36902189264398,1926-01-01
1927,-92.16666666666667,3.3482018,0.66977715,-96.24261558343125,-97.23104970408738,-54.51248899080054,1927-01-01
1928,-79.33333333333333,3.3482018,0.66977715,-92.51300236840993,-92.7460434779129,-52.655956088957105,1928-01-01
1929,-131.83333333333334,3.3482018,0.66977715,-89.95205896439096,-89.62779560413685,-50.79942318711367,1929-01-01
1930,-83.33333333333333,3.3482018,0.66977715,-88.63929592414847,-88.01097603283081,-48.94289028527023,1930-01-01
1931,-74.83333333333333,3.3482018,0.66977715,-88.51333505677779,-87.8607805311695,-47.086357383426794,1931-01-01
1932,-90.0,3.3482018,0.66977715,-89.37883750993151,-88.97685922194964,-45.22982448158337,1932-01-01
1933,-135.66666666666666,3.3482018,0.66977715,-90.92855270304878,-91.01593113779579,-43.373291579739934,1933-01-01
1934,-121.0,3.3482018,0.66977715,-92.7779993314362,-93.5305321662699,-41.5167586778965,1934-01-01
1935,-73.66666666666667,3.3482018,0.66977715,-94.50886381216412,-96.01952269962467,-39.66022577605306,1935-01-01
1936,-59.333333333333336,3.3482018,0.66977715,-95.71621755880764,-97.9846539226515,-37.803692874209624,1936-01-01
1937,-74.83333333333333,3.3482018,0.66977715,-96.05422342057742,-98.98680780142817,-35.94715997236619,1937-01-01
1938,-61.166666666666664,3.3482018,0.66977715,-95.27517215742053,-98.69556266688487,-34.09062707052275,1938-01-01
1939,-96.83333333333333,3.3482018,0.66977715,-93.25744269692058,-96.92648966264973,-32.23409416867933,1939-01-01
1940,-89.5,3.3482018,0.66977715,-90.01923015037204,-93.66197020911616,-30.377561266835887,1940-01-01
1941,-125.0,3.3482018,0.66977715,-85.71649203397885,-89.05318470605195,-28.52102836499245,1941-01-01
1942,-109.5,3.3482018,0.66977715,-80.62534451609338,-83.40304799832984,-26.664495463149013,1942-01-01
1943,-59.333333333333336,3.3482018,0.66977715,-75.11089571951973,-77.13201776935023,-24.807962561305583,1943-01-01
1944,-49.333333333333336,3.3482018,0.66977715,-69.58603402950075,-70.73063525029784,-22.951429659462153,1944-01-01
1945,-57.666666666666664,3.3482018,0.66977715,-64.46482318983965,-64.70415522731872,-21.094896757618717,1945-01-01
1946,-68.5,3.3482018,0.66977715,-60.115764730061876,-59.51551525164109,-19.23836385577528,1946-01-01
1947,-129.16666666666666,3.3482018,0.66977715,-56.82020324157109,-55.53308142064405,-17.381830953931843,1947-01-01
1948,-56.0,2.858907,2.7578495,-56.766058743666875,-52.98906894095923,-15.525298052088415,1948-01-01
1949,-42.166666666666664,5.30343,0.3216679,-33.14165204693525,-51.953330765373686,-13.668765150244978,1949-01-01
1950,-43.166666666666664,3.816473,1.2771947,-48.123371114793876,-52.325472919231515,-11.812232248401541,1950-01-01
1951,-58.5,1.5250142,1.7796396,-73.47601733235881,-53.846186501298966,-9.955699346558111,1951-01-01
1952,-34.166666666666664,3.4400053,-0.038776614,-57.197566289123344,-56.12651725599917,-8.099166444714674,1952-01-01
1953,-73.16666666666667,2.9387922,0.068978846,-64.34354576987563,-58.69176890501962,-6.242633542871238,1953-01-01
1954,-45.5,4.9915295,1.3730128,-41.477113185554785,-61.03508463619107,-4.386100641027801,1954-01-01
1955,-36.333333333333336,1.7126894,-0.22835702,-80.66033689578052,-62.674658722548195,-2.5295677391843716,1955-01-01
1956,-93.83333333333333,1.9961172,0.000106403706,-77.1377288530708,-63.208120492418864,-0.6730348373409346,1956-01-01
1957,-60.833333333333336,2.2547548,0.1852093,-72.77384963960841,-62.357952043137786,1.1834980645025024,1957-01-01
1958,-50.666666666666664,2.2449813,0.16877215,-70.4064344779542,-60.00281315993617,3.040030966345939,1958-01-01
1959,-93.16666666666667,0.14023231,0.20452765,-89.61558543958768,-56.191237630122345,4.896563868189369,1959-01-01
1960,-54.833333333333336,0.39210004,0.10180432,-82.38667423061503,-51.13615497686474,6.753096770032809,1960-01-01
1961,12.833333333333334,3.1401722,0.21283843,-46.955110294634125,-45.190855973566094,8.609629671876247,1961-01-01
1962,-39.666666666666664,3.64171,-0.080028,-36.383749914297724,-38.809114838810316,10.466162573719684,1962-01-01
1963,-97.0,0.13734382,0.23429385,-68.66689035779336,-32.49396933143075,12.322695475563117,1963-01-01
1964,-76.5,0.996338,-0.014845498,-54.836432987173986,-26.740940208273035,14.179228377406554,1964-01-01
1965,-21.833333333333332,2.9756749,-0.057570625,-29.36070831936009,-21.98209916587658,16.03576127924999,1965-01-01
1966,7.666666666666667,2.8802073,0.040577337,-27.408832993923294,-18.53729861441487,17.892294181093423,1966-01-01
1967,35.166666666666664,9.196815,1.3286175,45.07667588123636,-16.578068238208857,19.74882708293686,1967-01-01
1968,-29.333333333333332,0.853368,0.012949069,-47.5688455713606,-16.10825352968491,21.60535998478029,1968-01-01
1969,-43.0,0.55541885,-0.009784522,-51.51725843280307,-16.963581728230682,23.461892886623726,1969-01-01
1970,-9.833333333333334,4.2492,0.08066217,-12.538626669649116,-18.83020415873448,25.31842578846716,1970-01-01
1971,-60.166666666666664,1.1129643,-0.005539008,-48.67774332139459,-21.28012199762438,27.174958690310596,1971-01-01
1972,-88.33333333333333,0.33752108,0.5689417,-58.01427369591149,-23.819496772135025,29.03149159215403,1972-01-01
1973,-20.5,5.2323146,-0.33183584,-7.447043437062295,-25.94439253029155,30.888024493997467,1973-01-01
1974,-16.666666666666668,4.475806,0.34382138,-15.18278199673626,-27.19765776697474,32.7445573958409,1974-01-01
1975,-52.0,1.3508413,-0.021781223,-49.31270901960899,-27.22052654111236,34.60109029768433,1975-01-01
1976,-75.5,0.50272703,-0.014485825,-56.811234213909245,-25.793114291972504,36.45762319952777,1976-01-01
1977,-24.166666666666668,3.4437194,0.48148364,-20.997676751783356,-22.859237376800074,38.3141561013712,1977-01-01
1978,-31.833333333333332,3.2926567,0.1732222,-19.05015918341052,-18.53275481682784,40.17068900321464,1978-01-01
1979,-22.333333333333332,2.9034595,0.9794639,-17.072868314219257,-13.084716425124384,42.02722190505807,1979-01-01
1980,5.0,3.2153962,0.05390751,-9.685083695537415,-6.912767975313386,43.88375480690151,1980-01-01
1981,39.0,4.775985,0.022679903,12.835188152073178,-0.4962668121849667,45.740287708744944,1981-01-01
1982,15.333333333333334,3.0092428,1.2455628,0.7620473517978219,5.6578257565000065,47.596820610588374,1982-01-01
1983,52.833333333333336,4.976384,0.5348254,25.629714675775517,11.072167874042815,49.45335351243181,1983-01-01
1984,-9.5,2.5496292,0.3237051,2.396323115542174,15.35291724416242,51.30988641427525,1984-01-01
1985,-6.5,3.1703155,0.7953676,12.270635085655766,18.234186201705533,53.166419316118684,1985-01-01
1986,-13.0,3.5693567,0.817585,17.769225424861315,19.608053864888607,55.022952217962114,1986-01-01
1987,-20.5,1.8130171,0.13053775,-2.5132443280876657,19.536747738127424,56.87948511980555,1987-01-01
1988,55.833333333333336,7.3239822,0.3801851,56.95244425242676,18.24561976327633,58.73601802164899,1988-01-01
1989,17.833333333333332,3.806406,0.5001768,17.175825140100386,16.09770964966051,60.592550923492425,1989-01-01
1990,54.333333333333336,8.797221,1.2276878,70.86899117801272,13.552766654872581,,1990-01-01
1991,-48.0,2.5177867,0.22128223,-0.843578211205795,11.115355245469253,,1991-01-01
1992,-2.6666666666666665,4.6363235,0.46046934,21.538619117897987,9.27790222712883,,1992-01-01
1993,-5.166666666666667,2.31702,0.08018711,-4.51590054408949,8.465113917025214,,1993-01-01
1994,35.333333333333336,4.919285,1.2199252,26.62792928053635,8.98603728723684,,1994-01-01
1995,39.833333333333336,3.7871656,0.04719175,14.649309989892306,10.999176192418826,,1995-01-01
1996,-74.0,0.040142,0.014256987,-22.821583443754122,14.49460019830352,,1996-01-01
1997,-16.666666666666668,1.2264534,0.7445224,-4.282952982335026,19.29506548253245,,1997-01-01
1998,64.33333333333333,7.4432936,1.7884872,70.31967461377911,25.076021285792404,,1998-01-01
1999,58.666666666666664,5.2715096,1.1653932,51.204939795043494,31.40224367891089,,1999-01-01
2000,54.0,5.5184684,3.2992122,62.76422511869867,37.776961598146734,,2000-01-01
2001,61.0,3.4175305,0.1446687,39.88689769622726,43.697930032285385,,2001-01-01
2002,46.166666666666664,1.6989514,2.23091,28.655056117406296,48.71412108324394,,2002-01-01
2003,32.0,1.0597814,0.49877694,22.051541472032582,52.476633879228835,,2003-01-01
2004,62.833333333333336,6.299912,0.678191,81.33060289864852,54.778076868290626,,2004-01-01
2005,45.0,4.018306,0.046656903,56.10671215090008,55.57597720373948,,2005-01-01
2006,41.333333333333336,3.0318968,1.4427371,47.11712399178626,54.997574879819986,,2006-01-01
2007,94.83333333333333,5.71606,0.119684935,72.99404707455957,53.32546047810179,,2007-01-01
2008,66.33333333333333,4.781557,2.412327,64.67506135728327,50.96567766839351,,2008-01-01
2009,33.666666666666664,2.8233924,1.2740458,39.691499244487446,48.401890904231095,,2009-01-01
2010,25.333333333333332,0.7098519,-0.15642492,12.896644846037447,46.14079164845349,,2010-01-01
2011,60.166666666666664,4.5929317,2.1602745,58.12359101722607,44.654905417998556,,2011-01-01
2012,50.666666666666664,4.8021884,1.6506156,59.84813367608675,44.329255320384135,,2012-01-01
2013,25.666666666666668,1.0756603,0.12022516,18.25648954613451,45.41790245165074,,2013-01-01
2014,66.66666666666667,2.4486625,3.471638,41.22905112532002,48.01526867175704,,2014-01-01
2015,92.5,7.3712335,1.8507318,96.1661300787049,52.04547870800398,,2015-01-01
2016,77.0,3.0661945,0.8432111,52.42100331286347,57.27092459985131,,2016-01-01
2017,112.16666666666667,7.882341,1.1303532,110.74395134047754,63.319085770776084,,2017-01-01
